1,1,1,1,1,1,1,1,1,1
1,14,1,1,1,1,1,1,1,1
1,14,1,1,1,1,1,1,1,1
1,14,1,1,1,1,1,1,1,1
1,14,1,1,1,1,1,1,1,1
1,13,1,1,1,1,1,1,1,1
1,12,1,1,1,1,1,1,1,1
1,1,1,1,1,1,1,1,1,1