1,1,1,1,1,1,1,10,1,1
1,8,1,1,1,1,1,10,1,1
1,8,1,1,1,1,1,10,1,1
1,8,1,1,1,1,1,10,1,1
1,8,1,1,1,1,1,10,1,1
1,8,1,1,1,1,1,10,1,1
1,8,1,1,1,1,1,10,1,1
1,9,1,1,1,1,1,10,1,1